*********************
*          ***      *
**  *****  *   ***  *
*            *** *  *
* ************** ****
***  *****          *
*             *******
*    ******   *     *
*******       ****  *
*        *****   *  *
****             *  *
*       ***      *  *
*             ****  *
*  *****      *     *
*     **  **  *  ****
*     **  **  *  ** *
*     **  **  *  ** *
*     **  **  *  ** *
********  *****  ** *
*                   *
*********************
