*********************
*                   *
*  **********     * *
*  *   ****** ***** *
*  * * ****** *     *
*  * * ****** *     *
*  * *    *   *     *
*  * **** *   ***** *
* **    * *       * *
*     * * * ***** * *
* ***** *   *     * *
*       ***** * *** *
***** *   *   * *   *
*     *       * * ***
*******  ****** * ***
**       *      *   *
** ***** * ******** *
** *     *       ** *
*  * **  *******  * *
*    **             *
*********************
